900 600 0
263 262 256
60 1 0.4
0 0 1   0 1 0   1 0 0   1 1 1
1 1.5 0 0
6.75 3.25 1.5 1.5
0 -2
9 9
1.0 2.2
-0.1 0
 0.1 0
9 6
0 0 0 0 0 0 0 0 0
0 0 0 0 0 0 0 0 0
0 0 0 0 0 0 0 0 0
0 0 0 0 0 0 0 1 0
0 0 0 0 1 0 0 1 0
0 1 0 0 1 0 0 1 0