736 598 0
263 262 256
60 1 0.4
0 0 1   0 1 0   1 0 0   1 1 1
2 7.5 0 0
1.75 4.25 1.5 1.5
0 -2
9 9
3 4.2
-0.1 0
 0.1 0
16 13
0 0 0 0 0 0 0 0 0 0 0 0 0 0 0 0
0 0 0 0 0 0 0 0 0 0 0 0 0 0 0 0
1 0 0 0 1 0 0 0 1 0 0 0 1 0 0 0
1 0 0 0 1 0 0 0 1 0 0 0 1 0 0 0
1 0 0 0 1 0 0 0 1 0 0 0 1 0 0 0
1 0 0 0 1 0 0 0 1 0 0 0 1 0 0 0
1 1 1 1 1 1 1 1 1 1 1 1 1 0 0 0
1 0 0 0 1 0 1 0 1 0 1 0 1 0 0 0
1 0 0 0 1 0 1 0 1 0 0 0 0 0 0 1
1 0 0 0 1 0 0 0 0 0 0 0 0 0 0 0
1 0 0 0 0 0 0 0 0 0 0 0 1 0 0 0
1 0 0 0 0 0 0 0 1 0 1 0 1 0 0 0
1 0 0 0 1 0 1 0 1 0 1 0 1 0 0 0