990 594 0
263 262 256
60 1 0.4
0 0 1   0 1 0   1 0 0   1 1 1
0.5 1.5 0 0
0.25 7.25 1.5 1.5
-3 -2
9 9
3 3.3
-0.1 0
 0.1 0
15 9
0 0 0 0 0 0 0 0 0 0 0 0 0 0 0
0 0 0 0 0 0 0 0 0 0 0 0 0 0 0
0 0 0 0 0 0 0 0 0 0 0 0 0 0 0
0 0 0 0 0 0 0 0 0 0 0 0 0 0 0
0 0 0 0 0 0 0 0 0 0 0 0 0 0 1
0 0 0 0 0 0 0 0 0 0 0 0 0 0 1
0 0 0 0 0 1 0 0 0 0 1 1 1 1 1
0 0 1 0 0 1 0 0 1 1 1 1 1 1 1
1 1 1 1 1 1 1 1 1 1 1 1 1 1 1