920 598 0
263 262 256
60 1 0.4
0 0 1   0 1 0   1 0 0   1 1 1
5 9.5 0 0
13.75 9.25 1.5 1.5
0 -2
9 9
1.0 2.2
-0.1 0
 0.1 0
20 13
0 0 0 1 1 1 1 0 0 0 0 0 0 1 1 1 1 0 0 0
0 1 1 0 0 0 0 1 0 0 0 0 1 0 0 0 0 1 1 0
1 0 0 0 0 0 0 1 0 0 0 0 1 0 0 0 0 0 0 1
1 0 0 0 0 0 0 0 0 0 0 0 0 0 0 0 0 0 0 1
1 0 0 0 0 1 0 0 0 0 0 0 0 0 1 0 0 0 0 1
0 1 0 0 0 0 0 0 0 0 0 0 0 0 0 0 0 0 1 0
0 0 1 0 0 0 0 0 1 0 0 1 0 0 0 0 0 1 0 0
1 0 0 1 0 0 0 1 0 0 0 0 1 0 0 0 1 0 0 1
0 1 0 0 1 1 1 0 0 1 1 0 0 1 1 1 0 0 1 0
0 0 1 0 0 0 0 0 0 1 1 0 0 0 0 0 0 1 0 0
0 0 0 1 0 0 0 0 0 0 0 0 0 0 0 0 1 0 0 0
0 0 0 0 1 0 0 0 0 0 0 0 0 0 0 1 0 0 0 0
0 0 0 0 0 1 1 1 1 1 1 1 1 1 1 0 0 0 0 0