600 600 0
263 262 256
60 1 0.4
0 0 1   0 1 0   1 0 0   1 1 1
1 10.99 5 -2
7.25 10.25 1.5 1.5
0 0
9 9
2 2
-0.2 0
 0.2 0
12 12
0 0 0 0 0 0 1 0 0 0 0 0
0 0 0 0 0 0 1 0 0 0 0 1
1 1 1 1 0 0 1 0 0 0 0 0
0 0 0 0 0 0 1 0 0 1 0 0
0 0 0 0 0 0 1 0 0 0 0 0
1 1 0 0 1 1 1 0 0 0 0 0
0 0 0 0 0 0 1 1 1 1 0 0
0 0 0 0 0 0 1 0 0 1 0 0
0 0 1 1 1 1 1 0 0 1 0 0
0 0 0 0 0 0 0 0 0 0 0 0
0 0 0 0 0 0 0 0 0 0 0 0
0 0 0 0 1 1 1 0 0 1 0 0