360 600 0
263 262 256
60 1 0.4
0 0 1   0 1 0   1 0 0   1 1 1
0.5 12.5 0 0
3.25 0.25 1.5 1.5
0 -2
9 9
1.0 2.2
-0.1 0
 0.1 0
9 15
0 0 0 1 0 0 0 0 1
0 0 0 0 1 0 0 0 0
0 0 0 0 0 1 0 0 0
1 1 0 0 0 0 1 0 0
0 0 1 0 0 0 0 1 0
0 0 0 1 0 0 0 0 1
0 0 0 0 1 0 0 0 0
0 0 0 0 0 1 0 0 0
0 0 0 0 0 0 1 0 0
0 0 1 0 0 0 0 0 0
0 0 0 1 0 0 0 0 0
0 0 0 0 1 0 0 0 0
0 0 0 0 0 1 0 0 0
0 0 0 0 0 0 1 0 0
1 1 0 0 0 0 0 1 1