600 600 0
263 262 256
60 1 0.4
0 0 1   0 1 0   1 0 0   1 1 1
1 9.5 0 0
11.25 0.25 1.5 1.5
0 -2
9 9
3 3
-0.1 0
 0.1 0
13 13
1 0 0 0 0 1 0 0 0 0 0 0 0
1 0 0 0 0 1 0 0 0 0 0 0 0
1 0 0 0 0 1 0 0 0 0 1 0 0
1 0 0 0 0 1 0 0 0 0 1 0 0
1 1 0 0 0 1 1 0 0 0 1 0 0
1 0 0 0 0 1 0 0 0 0 1 0 0
1 0 0 0 0 1 0 0 0 1 1 0 0
1 0 0 0 1 1 0 0 0 0 1 0 0
1 0 0 0 0 0 1 0 0 0 1 0 0
1 0 0 0 0 0 0 0 0 0 1 0 0
1 1 0 0 0 0 0 0 0 1 1 0 0
0 0 0 0 0 0 0 0 0 0 0 0 0
0 0 0 0 1 1 1 0 0 0 0 0 0