825 600 0
263 262 256
60 1 0.4
0 0 1   0 1 0   1 0 0   1 1 1
4 5.5 0 0
0.25 6.25 1.5 1.5
0 2
9 9
3 3
 0.1 0
-0.1 0
11 8
0 0 1 0 1 0 0 0 1 0 0
0 0 1 0 0 0 0 0 0 0 0
0 0 1 0 0 0 0 0 0 0 1
0 0 1 0 0 0 0 0 0 0 0
0 0 1 0 0 0 1 0 0 0 0
0 0 0 0 0 0 0 0 0 0 0
0 0 0 0 0 0 0 0 0 0 0
0 0 1 0 0 0 0 0 0 0 0