640 560 0
263 262 256
60 1 0.4
0 0 1   0 1 0   1 0 0   1 1 1
3.5 1.5 0 0
3.25 4.25 1.5 1.5
0 -2
9 9
1.0 2.2
-0.1 0
 0.1 0
8 7
0 0 0 0 0 0 0 0
0 0 0 0 0 0 0 0
0 0 0 0 0 0 0 0
1 0 0 0 0 0 0 1
0 1 0 0 0 0 1 0
0 0 1 0 0 1 0 0
0 0 0 1 1 0 0 0